Map:
------------
------------
------------
------------
------------
------------
------------
------------
------------
------------
--#%#%#%#%--
--#%#%#%#%--
--#%#%#%#%--
--#%#%#%#%--
---#%#%#%---
---#%#%#%---
----#%#%----
----#%#%----
------------
------------
------------
------------
------------
------------
Map/

Meta:
Name: Central Mass
PowerUp: 1
Meta/

Legend:
#) red-block.png
%) orange-block.png
Legend/