Map:
a----------a
-a--------a-
--Y-----Y---
------------
#-%-#-%-#-%-
#-%-#-%-#-%-
#-%-#-%-#-%-
#-%-#-%-#-%-
#-%-#-%-#-%-
#-%-#-%-#-%-
#-%-#-%-#-%-
#-%-#-%-#-%-
#-%-#-%-#-%-
#-%-#-%-#-%-
#-%-#-%-#-%-
#-%-#-%-#-%-
#-%-#-%-#-%-
#-%-#-%-#-%-
------------
------------
z----------z
------------
------------
------------
Map/

Meta:
Name: Columns
Time: 200
PowerUp: a
Unbreakable: Y
Meta/

Legend:
#) red-block.png
%) orange-block.png
a) darkgreen-block.png
Y) yellow-block.png
Legend/
