ap:
------------
------------
------------
------------
#-%-#-%-#-%-
#-%-#-%-#-%-
#-%-#-%-#-%-
#-%-#-%-#-%-
#-%-#-%-#-%-
#-%-#-%-#-%-
#-%-#-%-#-%-
#-%-#-%-#-%-
#-%-#-%-#-%-
#-%-#-%-#-%-
#-%-#-%-#-%-
#-%-#-%-#-%-
#-%-#-%-#-%-
#-%-#-%-#-%-
------------
------------
aa--------aa
------------
------------
------------
Map/

Meta:
Name: Columns
Meta/

Legend:
#) red-block.png
%) orange-block.png
a) green-block.png
Legend/